BCCABCCBACBACBACBACBACBACBACBACBACBACBACBACBACBACB
CABCAABCABCABCABCABCABCABCABCABCABCABCABCABCABCABC
ABCCCBCAAAAABBBBCBAABBCBAAABACAABCCABABABCAAAABACC
BCABCABBCACCCCACCAAAAABCBACBCAAAABBACCCBACCCACABAA
CABCCCCBABCCBCABACBAABBCCBBACCCCBBCACCBAACCBABCACA
ABCACBBCAAABCABBCBABCACBBCACBCAABBBBBCAABABBBACCAB
CCABCBBCCCACACBACABCBAACABCCCACABABCBCAACBCCACCABA
BABAABBBBCCCBBBCBABCCBBCABACBABABBAAABCBABABCBCCBC
CACABCABACCCCABABCBBCBBABCBCBAABCBABCCAAACAAAACCBB
BBABCCCCCCAAABCABCABBBBABCABBBBACCBAABABCAACCCABAC
ACBAABAABCACCACCCBCCABCABCABCABCABCABCABCABCABCABC
BBBACCABCBBCABCABCABCABCABCABCABCABCABCABCABCABCAB
BCBCBAAAABCABCAABACBBACACCCCCACCACAABACBABCABBCCCA
BACABBBAACBBCABCABABCCAACCACACBCBBCBAAACBABACBBCAA
AACCBABCAAABBBBABCABCABACBACBACBCCBBABCABABCABCAAB
BCCAACBBBCABCBCBBABCABCBABBABBBAAABCCBCCBAACBCCAAA
CABBBBACBABCBBBAACABBBBBABACCACCCBACCCBBCCBAABBAAC
BBABBCBCACAABABBCAAACCBBAAAABBBABBBBAABAABCCABAAAA
AABBBBCBCABBBCCBBCBAABCBBBCCAACCBCCAACAAACBBCCBCCA
ABBCACBCBCAAABCABAABACABCABACBBAABABAAAABAAACACBAC
CACABBABCACBBBCBABACAACBABCACACACCBBCCCAAACCBBBABB
ABCACCABBABABAAABCAAABABBAAACABBBBACCACBCCBCABACAC
BABABBBAACBBBACCBBBBCBACCACBCCABBBCCCBBAACBAAACBCB
ACCCABBCCCCABAACCCCABAABCBBCABCBBBCCBAABCBCBCBACCA
CCACBCBCBBAAABAACCBBBBCCACABBCCCBAAAABBCCBCBBCBCCC
BBCABACCCACAABBABCABABABCBBCABCACCBABCCBCCACBACBCA
BCCBBBAAACAACBBBBBCACBCBACAACAABCAABCCCCAABCCCABCB
ABCBCAAAABCCCABABCABCAABACABCABABCABBABAAABCBABBBA
ACACCBCBBBCCBBBACBABABBCBBCABBCAACBABAAAABABACACAB
ACAAAABBBBBABBBBBCCBBCCCBACBCBCBCABCBACCCABBBCCABB
ACBBACBBCBCCBABAAAABBAACAABCBBCCCACACCACABBAAABBCC
ABCCCCCBBCABACBCCAABCCACABCBAABCBCBBBABBCAABCBBBBC
AAABBBCBCACCBABBCACAACABABCBCCAAABBCCCBCABAAAAABBA
AACABCABABACBBACABCBBABBCAAAABAACAAABABCBAABBABACB
BABACCBBBCCCBCABACBABBBBBBCBBBCBBCCCCAAAACABCACCBC
ABBCABACCBABCCCABCBCBBCBBBABAABAABAACBCBBBBAAAAABA
CACCBACBCBCBBACACBABAACCBCCBCBBAABCACCAABAABABBBBC
CCBACBBCCCAACBABAAABBABABABCACCCBBCAAABCABCBBACAAA
BCBACCBBACBCBCCACCAAABCBBBAABBBBCABCBCBBBBABACBCCC
BCABCACBACCCCCBBBAAABABAACBABCACCACBBCABBABCABCBAB
CBBBBBBAABCBCACCAABBBBABAACBCCACABABCBBCCBCACBABAB
BBABBCCBABABBCAAAAACABCAAAABBBCBAACBAACBACACACBABB
AAABBBABBACAACBBBBBACBACCCCABACCAACCCAAAACBAAACABB
ABABBBACCCACAABCCBCABACACABBBBBBABCCBCCABACCCBACCB
AABBABCBBABBACABACBABBAAABCBACBABCABCACABACAACBCAB
CBBBCBABBBAAAABACCABACCBCAACABCBBCBBAACBCAAACBBAAC
ABABAAACCBACACABABBCBBCABACCCBBCCAABAAABCBBABAACBA
BBABCCACAACCBCABAACAABACCCAAABBBCCABCABBACCBBCCAAB
CAABABACACCAABCBBBCCAAAAACACBBBAAACCBBCABCCBBABBAC
BCABABBBACBAABACABCBABAAABCBBCCBCAACCBBCABBBAABBCA
