ABCABCBABBACBAAA
CCCBAABACCBCBBBC
CBABBBCACCBABCBA
CACBACBBCABCABCA
BBCBBBAAAAAAAABA
BBAACACBBBBBCAAA
ACBBBCCBCBAAABCC
ABABABCBBBACCCAB
CCABBBBABCABABBC
BACBABCABBCABCCA
BAABCACBBBBBABCB
BCBCBCCCCBBBBCAC
CABBBCCCAABACACA
