BCAABCCCBACCACABACCCCAABCBBACBBBBBCCCCABACABABBAAA
CABCCACCBABCACABBACBCACACCABABBBAABBAACACBCAAACCAC
CBCAAAACABCACCBBCAAAABCBABACBAABBBBABACAACCBAABCBC
AABBCCCAAAACCBCBCACACBCBCCCAACCABCABBACCAABCCACCBC
BCBAABAACABBBBBBCBBCACBCAABBBBBCABBAAACCBACBABABBB
CAABACABACABBBBACCCBCABAAAAABAABCACBAACCABBAACABCA
ACBBCCACAABACACCACACAABAABBCCACBAACACBBBBBABCCCABC
BCABCAAABCAACBCACBCACCCBACCABABBCCCBCBBBABBAAACCAB
BABCBBABCABCABCABCABCABCABCABCABCABCABCABCABCABCAB
ABCABCABCABCABCABCABCABCABCABCABCABCABCABCABCABCAB
