ACABCABCABC
BCBABABBABA
AABCCBACCAA
BCBBACABCCA
BABACACBBCA
CBAABCBAABA
CACCCAABCCB
