BCABCCABCABCABCABCABCABCABCABCABCABCABCABCABCABCABCABCABCABCABC
CABAABBCBBCAACBCCABABBACBCACAAACAACCAABBBCABCAABCAAABCBBCBABACA
ABCBCAAABCCCCCBABBCABCBCBBCCABABBCBACCABBCAABAAABABCACACBBACAAC
BBCACBCCBABAACCCAACACAABBCBAACCAAAABBBCCCCACCBBAAACACCCBACBCBAA
CAABABCCBBAAAABCCACCABCACCABBAACACACCACBABBCCCABBACBCBACBBCABBB
CBCABCABBCACACCABBCBACABCBCACCACACCCCACBBACCAAACCBCCBAAABCABBAA
ACCBCBACACBCABABABAACABAACAAACBACCBBCCBACAABBBACAABAAAABAACABCA
BCAAAABBBCACBBBABBBBCBCBAABBCCACCBABAABCCABBBCCAAABAACACBCCCCCA
CBBCBCBCACCABABBCAACABABACCCAAAABBBABCACCBACBCBCCACBACBBABBCACB
BCBACBBBCCCAABAAAACBACBACABBAAACBACCBABCCAACCABACBABAACCBAABCCA
BACAABCCACAACCCCBBCACCCCAAABCCABACBBAABACCABBBCAABCCAABACBBCCCA
CABBBBABBCBBCABABABCCAACCBBBCABBCBAABBBACACACBACBBBABBBBCBCABCC
ACACCBBCACCAAACCCBAAACBABACCAACCCCBBCCBABBCBABBBABAAACCBBBBBBBA
BCACACBBCACBAACACBCACACBCCBACCBCCCBBACCAACACCBCBACABBABAACAABBA
CCABBCACBACBCABCBCACBAAABABBABABBCBABBCAABBCBCCBCBACACCCABBAABB
AAAACAACCCABABCABBBCBABCABBBBACBCCCAAAACBACCCBBBBBCCCBCAAAACBCB
BBBBACCAAABABAAAAABBCCABBBCBCACCCBACBBAACABABBBABBCAABACCBCCACC
CCBBBBACBBABACBBAACBABACCABCCCBBCBABBBCBBBABAABBBCCCCCABBAABABB
ABCCCCCCBACCBABCBBBCBAACCACABAAABBBACCBCCCBACAABCBABACCCBABBACC
BACBACCBBCBBAACBBACBABAACABACBBBBACBABBAABABABBCAACACBAABAAACCA
CCCCBBCBBABBCACCACBCAABBBBBAABCCACBCACCAABBBAACBCACCBBCAACBAAAA
ABCBCAAAAACCACAAABACAABBACACBCABBAABBAAACABBACCBAAAABBBCCBAAACA
BCCCABAAAACBBBCAABABACACAABBBABBBBBBBCBCCBCAACAAAABAACBCBBACACC
CCBABBBABBCABBCCBBBCCCBBCCBBCBBBBAACBACCBBAAACCBCABCBAABACBAABB
AAACCABCACACCBBCBBABBCBCBCAABCABBCBBABCBAACCBCCCBCCBCCABABBCBCB
BAABACCCACAABCCABBABACBBCABCCCACABCABBCCCBCCCBCBACABBBBACCACABC
CCACBCCABCAACAACABACBCCBCAAAAACCCBACAABCCCBABCABACABBCBAABAABCC
AAACCCBACACBBACAACBBBACCBBBABBCCAAACBABBACCBACCBBBAACCABCBCCCCC
BCBBAACABBCBCCCBBABABBBCAACCCBACBCBABBABCBCABABAAAACAACBACABABB
CABBBBCCCBBBAAAAACACCABBACCACCACCABCACAABCAACABBAABCBBABAACBACB
ABABCCCAABCBACBCACCBAAACACCABABABBBBCCAAACCCCCBAAAABCBACACABCCA
BAAAACBABBAAACBBCCBCBBACBCBBCBCCBBCCBAABABCCBCCCAAAAABCCBBCAACB
CACBBCCCAABCCAACBCCCCCCAABAAACBABACBCABBAABBAACCABCBCACABCCBCBB
ACBBCACCCBBACABCCCAACCAACBBBBCCAABACCACABABCACBCCBCAACAABBBAABA
BBCCABAABCCCBABABBACBACBACBACABCAAABACABCCCCACBBBCCABCCBCAABABB
CACCBCAABBBAABBBABBACAACBCACCBCBACCCABACBABAABCCAABAAABCCCAACCB
AABBCCBCACACAACAABBBACABBACACCABBAAAABAABCAACCBAACCBAABCAAABCBA
BBAAABCBCCAABCBBAABCACBCCCBCBABCBAAABCACCACACABACCCABAACABCAABA
CBACBABACABCCCAABBBACBBABCABBCCCBBCAAACACBABABCABBBBABCCAAABCCC
AACBCBCACCBBCBBBBACAACCBBBACAACCAACACBAAACABCACABCCCBBCCCACACCC
BBBCACACCBABCABABBAAABCBBCCCBCACBCBCABCBBACCCCBCBCAABBAACCAACBC
CAACBBBCACBCCACBACBAABABCACCBAAACBCABCCCCCABCBBACCBCBCCBCBACABB
ACCBCACCCCCAAAAACCCCCCAAABBCCCBABCBBBBACCAABAACBCBBABABBBBBAABB
BBBBAABAABABACBACACAABABCBCCAAACBABCCCAAACBABBCBCACBABAACCAAABC
CCAABABABABABACBBBBACBABCBBCBBCBCABBBACBBBAAABCCCBBBCAACCCCACCC
ACCBCBCABBABABBBBBACCCAABABAABBCCCBCBBCCBCBACAACCAACBAACCCCCCCA
BCBCACCBACBACCCACCACABBAACBCAACACBBCBBBCBCBBCBABBCCACCAABBAAAAB
CCBCBCBBAABABABBCAABCCACBAACCCBACAAACBCABCBCCACCBBAAABABCACBCCB
AAABCCBBACBACABBCBBACBABBCCAAAABAAAACBABCCCCBCCBBCABBCABAACABBA
BBBBACACABBACBCAABBAACBCABBACBACCAAABCBCBBCAACCBBBACCABBBACAABC
CCBBBCBBCBAAAAACACCBAAAAABCCBCAABAACABCCABBCBCBBAABCBCAABCAACAC
ABCBCCCAABAAABCCBCACCBBACBCAAACCBAACACACBBCCACAAABABACBBABBBCBC
BBCCABABCCBCCAABCCCACCACBABCBCABCACCCACACBABBACBCBBBBBAABBCCBCC
CABCBCAAABCABCCAABACBCACBBBCACCABACBAAACABABABBCACACACACBCBABBB
AAABCACCACBCBBAACAAAABBCACCABBCABBACCABCBACCCBBCCCBBACBCBBACACA
BCBCABCABBCBBBCABCAABCCCACCAACABCAABCABAAACCBABBAAAABCACCACABBC
CBAABCCBCACBCCAACAABCABBBCBBCBABBBCAACBBCCCCBCBBCABCCACABACBCBB
ABCABAAAAABACCAAAACBBCCABBBAABACBCABCABCCBABCCBCAAABBACBACACAAC
BAAACCCABCABBCBAAAABACCAAAAAABBBCBBABCBBABCBCBABCBBBBACBBCBCCCA
CACBBACCACBAAABCBAAABBAACACAAABACCACBBACCABBAAAACABACABCBACCBAB
CBBAABBABBABCACACCCBACACCBACCCCBBBBBCCABCCABCCBCBCCBABAAAABBCBB
ABBBAAAACCAABABCCBBBAABCAACABABAACACCBAACBCBABBACAAACCBACCBCABC
BCBBCCBABCBBCCCACACAABBBACCABCBABCBBCBACBCCBABACABAAABBACCBBACA
CAABCBCABBCBBBCBCABBBBAABBACABCBBCCABAABAABCCBCBBBBAACAABABCACA
AAACACBCCBACABBAAACBACCCACCBCBCCBBABBCBCCBAABBAABCCAABABBCBABAA
BAAAABAAACBCACAAACABBBAACAAACCBBBCBABCCBACBBBBAAAAAACCCCBCBCACC
CBABAABAABABCCABBBCCACCCCCBCBCACACBCAABCBCACBAAAABACCCBBBCAACCA
ABBBCACACABABBACBAAABAACCCCACAACACABCBCBBABABCBBAABAAAACCBCCBBA
BCCCCCCBACBBCCBACCABBAAAABACCBCABABBCCABBCCBCAABCBACCBBAAAABAAB
CCCCCABACACBAAAACACACABABBBBCAACBCCCBABBCCBBABBCABABBBACAACBACB
ABBCCCAAABCBACACCACBAABBCABCCCAACABCBBABABABBAACAACACCACCBBCABA
